PPPPPPPPPPPPPPPPPPPPPPPPPPPPPPPPPPPPPPPPPPPPPPPPPPPPPPPPPPPPPPPPPPPPPPPPPPPPPPPPPPPPPPPPPPPPPPPPPPPPPPPPPPPPPPPPPPPPPPPPPPPPP
P                                                      P             P                   P                                  P
P                                                      P             P                                                      P
P                                                      P             P                                                      P
P                                                      P                                                                    P
P                                                      P                                                                    E
P                                                                                                               PPPPPPPPPPPPP
P                                                                                                                           P
P                                                                                        P                                  P
P                                                                                        P                                  P
P                                                                                        P      BBBB                        P
P                                                                    P                   P                                  P
P                                                                    P                   P                                  P
P                   FFFFFFFFFFFFFFFF                   P             P                   P                                  P
P                  PPPPPPP                             P             P                   P                                  P
P                 PPPPPPPP                   BBB       P    BBB      P        BBB        P                                  P
P                PPPPPPPPP                                                                                                  P
P               PPPPPPPPPP                                                                                                  P
P                                                                                                                           P
PPPPPPPPPPPPPPFFFFFFFFFFFFFFFFFFFFFFFFFFFFFFFFFFFFFFFFFFFFFFFFFFFFFFFFFFFFFFFFFFFFFFFFFFFFFFFFFFFFFFFFFFFFFFFFFFFFFFFFFFFFFFP