PPPPPPPPPPPPPPPPPPPPPPPPPPPPPPPPPPPPPPPPPPPPPPPPPPPPPPPPPPPPPPPPPPPPPPPPPPPPPPPPPPPPPPPPPPPPPPPPPPPPPPPPPPPPPPPPPPPPPPPPPPPPP
PPPPPPPPPPPPPPPPPPPPPPPPPPPPPPPPPPPPP             X                   PPPPPPX                 $    PPPPPPPPPPPPPPPP$PPPP    P
PPPPPPPPPPPPPPPPPPPPPPPPPPPPPPPPPPPPP             X                   PPPPPPX                 $    PPPPPPPPPPPPPPPP$PPPP    E
PPPPPPPPPPPPPPPPPPPPPPPPPPPPPPPPPPPPP             X22222    SPPPPPPDDDPPPPXXX   PPPPPPPPPPPPPP$    PPPPPPPPPPP     $  PPUUUUP
PPPPPPPPPPPPPPPPPPPPPPPPPPPPPPPPPPPPP             X         SPPPPPP   PPPP      XPPPPPPPPP    $    PPPPPPPPPPP     $  TT    P
PPPPPPPPPPPPPPPPPPPPPPPPPPPPPPPPPP                X         SPPPPPP    PPP      XPPPPPPPPP    $    PPPPPPPPPPPP    $UUPPPPPPP
PPPPPPPPPPPPPPPPPPPPPPPPPPPPPPP                   P         SPPPPPP     PP      XPPPPPPPPP    $PPPPPPPPPPPPPPPPP   $     PPPP
PPPPPPPPPPPPPPPPPPPPPPPPPPPP                      P         SPPPPPP      P      XPPPPPPPPP    $    PPPPPPPPPPPPPP  $     PPPP
P                                                 P         SPPPPPP             XPPPPPPPPP    $    PPPPPPPPPPPPPPUU$    PPPPP
P                                                 P         SPPPPPP             XPPPPPPPPPPPPP$    PPPPPPPPPPP     $   PPPPPP
P              @                                  X         SPPPPPP             XPPPPPPPPP    $    PPPPPPPPPPP     $  PPPPPPP
P              @                                  X         PPPPPPP             XPPPPPPPPP    $    PPPPPPPPPPPP    $UUPPPPPPP
P              @                                  X         PPPPPPP             XPPPPPPPPP    $PPPPPPPPPPPPPPPPP   $     PPPP
P    PPPPPPPPPPPPPPPPPPPPPPPPPP333333             X         PPPPPPP             XPPPPPPPPP    $    PPPPPPPPPPPPPP  $     PPPP
PUUUUP                  SPPPPPP                   X444444444PPPPPPP             XPPPPPPPPP    $    PPPPPPPPPPPPPPUU$    PPPPP
P                       SPPPPPP                   X         PPPPPPP             XPPPPPPPPPPPPP$    PPPPPPPPPPPPPP  $   PPPPPP
PPPPPPSSSSSSSSSSSPPPP   SPPPPPP                   X         PPPPPPP             XPPPPPPPPP    $    PPPPPPPPPPPPPP  $  PPPPPPP
P                       SPPPPPPPPPPPPP            X         PPPPPPP             XPPPPPPPPP    $                    $UUPPPPPPP
P                       SPPPPPPPPPPPPP            X         PPPPPPP             XPPPPPPPPP    $                    $  PPPPPPP
PPPPPPPPXXXXXXXXPPPPPPPPPPPPPPPPPPPPPPXBBBBXXXXXXXXXXXXXXXXXXXXXXXXXXXXXXXBBBBBXXPPPPPPPPPPPPPPPPPPPPPPPPPPPPPPPPPPPPPPPPPPPP