PPPPPPPPPPPPPPPPPPPPPPPPPPPPPPPPPPPPPPPPPPPPPPPPPPPPPPPPPPPPPPPPPPPPPPPPPPPPPPPPPPPPPPPPPPPPPPPPPPPPPPPPPPPPPPPPPPPPPPPPPPPPP
P                                                                                                                           P
P                                                                                                                           P
P                                                                                                                           E
P                                                                      VVVVVVVVVV                  VVVVVVVVVV            PPPP
P                                                                                                                           P
P                                                            VVVVVVVVVV                                                     P
P                                                                                                                           P
P                                                  VVVVVVVVVV                                                               P
P                                                                                                                           P
P                                        VVVVVVVVVV                                    BBBBBB                               P
P                                                                                                                           P
P                              VVVVVVVVVV                                                                                   P
P                                                                                                                           P
P                    VVVVVVVVVV                                                                                             P
P                                                                                                                           P
P        PVVVVVVVVVVV                                                                                                       P
P       PP                                                                                                                  P
P      PPP                                                                                                                  P
PPPPPPPPPPXXXXXXXXXXXXXXXXXXXXXXXXXXXXXXXXXXXXXXXXXXXXXXXXXXXXXXXXXXXXXXXXXXXXXXXXXXXXXXXXXXXXXXXXXXXXXXXXXXXXXXXXXXXXXXXXXXP