PPPPPPPPPPPPPPPPPPPPPPPPPPPPPPPPPPPPPPPPPPPPPPPPPPPPPPPPPPPPPPPPPPPPPPPPPPPPPPPPPPPPPPPPPPPPPPPPPPPPPPPPPPPPPPPPPPPPPPPPPPPPP
PPPPPPPPPPPPPPPPPPPPPPPPPPPPPPPPPPPPP             P                   PPPPPPP                      PPPPPPPPPPPPPPPPPPPP     P
PPPPPPPPPPPPPPPPPPPPPPPPPPPPPPPPPPPPP             P                   PPPPPPP                      PPPPPPPPPPPPPPPPPPPP     E
PPPPPPPPPPPPPPPPPPPPPPPPPPPPPPPPPPPPP             P         SPPPPPPDDDPPPPPPP   PPPPPPPPPPPPPPPX   PPPPPPPPPP         PPUUUUP
PPPPPPPPPPPPPPPPPPPPPPPPPPPPPPPPPPPPP             P         SPPPPPP    PPPPPP   PPPPPPPPPP         PPPPPPPPPPP              P
PPPPPPPPPPPPPPPPPPPPPPPPPPPPPPPPPP                P         SPPPPPP     PPPPP   PPPPPPPPPP         PPPPPPPPPPPP     UUPPPPPPP
PPPPPPPPPPPPPPPPPPPPPPPPPPPPPPP                   P         SPPPPPP      PPPP   PPPPPPPPPP   XPPPPPPPPPPPPPPPPPP          PPP
PPPPPPPPPPPPPPPPPPPPPPPPPPPP                      P         SPPPPPP       PPP   PPPPPPPPPP         PPPPPPPPPPPPPP        PPPP
P                                                 P         SPPPPPP        PP   PPPPPPPPPP         PPPPPPPPPPPPPPUU     PPPPP
P                                                 P         SPPPPPP         P   PPPPPPPPPPPPPPPX   PPPPPPPPPP          PPPPPP
P                                                 P         SPPPPPP             PPPPPPPPPP         PPPPPPPPPPP        PPPPPPP
P               (                                 P         SPPPPPP             PPPPPPPPPP         PPPPPPPPPPPP     UUPPPPPPP
P               (                                 P         SPPPPPP             PPPPPPPPPP   XPPPPPPPPPPPPPPPPPP          PPP
P    PPPPPPPPPPPPPPPPPPPPPPPPPPPP                 P         SPPPPPP             PPPPPPPPPP         PPPPPPPPPPPPPP        PPPP
PUUUUP                  SPPPPPPPPP                P         SPPPPPP             PPPPPPPPPP         PPPPPPPPPPPPPPUU     PPPPP
P                       SPPPPPPPPPP               P         SPPPPPP             PPPPPPPPPPPPPPPX   PPPPPPPPPPPPPP      PPPPPP
PPSSSSSSSSSSSSSSSSSSP   SPPPPPPPPPPP              P         SPPPPPP             PPPPPPPPPP         PPPPPPPPPPPPPP     PPPPPPP
P                       SPPPPPPPPPPPP             P         PPPPPPP             PPPPPPPPPP                          UUPPPPPPP
P                       SPPPPPPPPPPPPP            P         PPPPPPP             PPPPPPPPPP                            PPPPPPP
PPPPXXXXXXXXXXXXXXXPPPPPPPPPPPPPPPPPPPPBBBBXXXXXXXXXXXXXXXXXPPPPPPPBBBBBBBBBBBBBPPPPPPPPPPPPPPPPPPPPPPPPPPPPPPPPPPPPPPPPPPPPP