PPPPPPPPPPPPPPPPPPPPPPPPPPPPPPPPPPPPPPPPPPPPPPPPPPPPPPPPPPPPPPPPPPPPPPPPPPPPPPPPPPPPPPPPPPPPPPPPPPPPPPPPPPPPP
P                                                                                                 PPPPPP    P
P                                                                                                 PPPPPP    P
P                                                                                                 PPPPPP    P
P                                                                                                 TTTTTT    P
P                                                                                                 TPPPPP    P
P                                                                                                 PPPPPP    P
P    FFFFFFFFFFFFFFFFFFFFFFFFFFFFFFFF        PPPPPPPPPPPPPPPPPPPPPPPPPPPPPPPPPPPPPPPPPPPPPPPPPDDDDPPPPPP    P
P                       PPPPPPPPPPPPP        PPPPPPPPP    P                                       PPPPPP    P
P                       PPPPPPPPPPPPP        PPPPPPPPP    P                                       PPPPPP    P
PBBBB                   SPPPPPPPPPPPP        PPPPPPPPP    P                                       PPPPPP    P
PPPPPPPPPPPPPPPPP       SPPPPPPPPPPPP        PPPPPPPPP    PPPPIIIIIPPPPPPPIIIIIPPPPPPPIIIIIPPPPPPPPPPPPP    P
P               P       SPPPPPPPPPPPP        PPPPPPPPP             P           P           P      PPPPPP    P
P               P       PPPPPPPPPPPPP        PPPPPPPPP             P           P           P      PPPPPP    P
P               P       PPPPPPPPPPPPP        PPPPPPPPP             P           P           P      PPPPPP    P
P     PPPPPPPPPPPPPPPPPPPPPPPPPPPPPPP        PPPPPPPPPPPPPPPPPPPPPPPPPPPPPPPPPPPPPPPPPPPPPPPPPDDDDPPPPPP    P
S    PPPPPPPPPPPPPPPPPPPPPPPPPPPPPPPPXXXXXXXXPPPP              PPPPPP              PPPPPP         PPPPPP    P
P    PPPPPPPPPPPPPPPPPPPPPPPPPPPPPPPPPPPPPPPPPPPP    PPPPPP    PPPPPP    PPPPPP    PPPPPP    PPPPPPPPPPP    P
P    PPPPPPPPPPPPPPPPPPPPPE                          PPPPPP              PPPPPP                        I    P
PPPPPPPPPPPPPPPPPPPPPPPPPPPPPPPPPPPPPPPPPPPPPPPPPPPPPPPPPPPPPPPPPPPPPPPPPPPPPPPPPPPPPPPPPPPPPPPPPPPPPPPPPPPPP