PPPPPPPPPPPPPPPPPPPPPPPPPPPPPPPPPPPPPPPPPPPPPPPPPPPPPPPPPPPPPPPPPPPPPPPPPPPPPPPPPPPPPPPPPPPPPPPPPPPPPPPPPPPPPPPPPPPPPPPPPPPPP
P                                                                                                                           P
P                                                                                                                           P
P                                                                                                                           P
P                                                                                                                           P
P                                                                                                                           P
P                                                                                                                           P
P                                                                                                                           P
P                                                                                                                           P
P                                                                                                                           P
P                                                                                                                           P
P                                                                                                                           P
P                                                                                                                           P
P                     P                     P                                                       P                       P
P                     P                     P           P          P                     P          P                       P
P                     P           P         P           P          P          P          P          P                       E
P        PVVVVVVVVVVPPPPPVVVVVVVVVPVVVVVVVVVPVVVVVVVVVVVPVVVVVVVVVVPVVVVVVVVVVPVVVVVVVVVVPVVVVVVVVVVPVVVVVVVVVVVVVVVVVVVVPPPP
P       PP                        P         P           P          P          P          P          P                       P
P      PPP                        P         P           P          P          P          P          P                       P
PPPPPPPPPPXXXXXXXXXXXXXXXXXXXXXXXXXXXXXXXXXXXXXXXXXXXXXXXXXXXXXXXXXXXXXXXXXXXXXXXXXXXXXXXXXXXXXXXXXXXXXXXXXXXXXXXXXXXXXXXXXXP