PPPPPPPPPPPPPPPPPPPPPPPPPPPPPPPPPPPPPPPPPPPPPPPPPPPPPPPPPPPPPPPPPPPPPPPPPPPPPPPPPPPPPPPPPPPPPPPPPPPPPPPPPPPPPPPPPPPPPPPPPPPPP
PPPPPPPPPPPPPPPPPPPPPPPPPPPPPPPPPP              PP                 $                              *                *        P
PPPPPPPPPPPPPPPPPPPPPPPPPPPPPPPPPP              PP                 $                              *                *        P
PPPPPPPPPPPPPPPPPPPPPPPPPPPPPPPPPP                                 $                              *                *        P
PPPPPPPPPPPPPPPPPPPPPPPPPPPPPPPPPP                                 $                              *                *        P
PPPPPPPPPPPPPPPPPPPPPPPPPPPPPPPPPPUUUUPPPPPPPPPP  PPPPPPPPPPPPPDDDDDDDDDFFFFFFFFFFFFFFFFFF        *                *        P
PPPPPPPPPPPPP                         SPPPPP          PPPPPP                                                                P
PPPPPPPPPPPP                          SPPPPP          PPPPPP                                                                P
PPPPPPPPPPP                           SPPPPP2222222222PPPPPP                                                                E
PPPPPPPPPP                            SPPPPP          PPPPPP                      PPPPPPPPPPPPPPPPPPPPPPPPPPPPPPPPPP     PPPP
PPPPPPPPP                             SPPPPP          PPPPPP                      P                                         P
PPPPPPPP                              TTTTTT          TTTTTT                      P                                         P
PPPPPPP                         IPPPPPPPPPPPPPPPTTPPPPPPPPPPPPPPPP                P                                         P
PPPPPP                         I      PPPPPPPPPPTTPPPPPPPPPP                      P                                         P
PPPPP                         I       PPPPPPPPPPTTPPPPPPPPPP                      P                                         P
PPPP                         I        P                    P            BBBB      PPPPPPPPPPPPPPPPPPPPPPPPPPPPPPPPPP        P
PPP                         I         P                    P                                                            UUUUP
PP                                    P                    P                                                                P
P        PVVVVVVVVVVVVVVVVVVVVVVVVVVVVPVVVVVPVVVVVVVVPVVVVVPVVVVVVVVVVVVVVVVVVVVVVVVVVVVVVVVVVVVVVVVVVVVVVVVVVVVVVVVVVVVVVVVP
P       PP                            P                    P                                                                P
P      PPP                            P                    P                                                                P
PPPPPPPPPPXXXXXXXXXXXXXXXXXXXXXXXXXXXXXXXXXXXXXXXXXXXXXXXXXXXXXXXXXXXXXXXXXXXXXXXXXXXXXXXXXXXXXXXXXXXXXXXXXXXXXXXXXXXXXXXXXXP