PPPPPPPPPPPPPPPPPPPPPPPPPPPPPPPPPPPPPPPPPPPPPPPPPPPPPPPPPPPPPPPPPPPPPPPPPPPPPPPPPPPPPPPPPPPPPPPPPPPPPPPPPPPPP
P                                                                                                           P
P                                                                                                           P
PTTTTPPPPPPPPPPPPPPPPPPPPPPPPPPPPPPPPPPPPPPPPPPPPPPPPPPPPPPPPPPPPPPPPPPPPPPPPPPPPPPPPPPPPPPPPPPPPPPPPPPPDDDDP
P                                                                                                 PPPPPP    P
P                                                                                                 PPPPPP    P
P                                                                                                 PPPPPP    P
P    FFFFFFFFFFFFFFFFFFFFFFFFFFFFFFFF          PPPPPPPPPPPPPPPPPPPPPPPPPPPPPPPPPPPPPPPPPPPPPPPDDDDPPPPPP    P
P                       TPPPPPPPPPPPP          PPPPPPP    I                                       PPPPPP    P
P                       TTTTTTTPPPPPP          PPPPPPP    I                                       PPPPPP    P
PBBBB                   PPPPPPTPPPPPP          PPPPPPP    I                                       PPPPPP    P
PPPPPPPPPPPPPPPPP       SPPPPPTPPPPPP          PPPPPPP    PPPPXXXXXXPPPPPPXXXXXXPPPPPPXXXXXXPPPPPPPPPPPP    P
P               P       SPPPPPTPPPPPP          PPPPPPP    I        X           X           X      PPPPPP    P
P               P       PPPPPPTPPPPPP          PPPPPPP    I        X           X           X      PPPPPP    P
P               P       PPPPPPTPPPPPP          PPPPPPP    I        X           X           X      PPPPPP    P
P     PPPPPPIIIIPPPPPPPPPPPPPPTPPPPPP          PPPPPPPPPPPPPPPPPPPPPPPPPPPPPPPPPPPPPPPPPPPPPPPDDDDPPPPPP    P
S    PPPPPPT    T       TTTTTTTPPPPPPXXXXXXXXXXPP              PPPPPP              PPPPPP         PPPPPP    P
P    PPPPPPTIIIIPPPPPPPPPPPPPPPPPPPPPPPPPPPPPPPPP    PPPPPP    PPPPPP    PPPPPP    PPPPPP    PPPPPPPPPPP    P
P    PPPPPPT              E                          PPPPPP              PPPPPP                             P
PPPPPPPPPPPPPPPPPPPPPPPPPPPPPPPPPPPPPPPPPPPPPPPPPPPPPPPPPPPPPPPPPPPPPPPPPPPPPPPPPPPPPPPPPPPPPPPPPPPPPPPPPPPPP