PBBBBBBBGGGBBBPPPBBBGGGBBBPPPBBBGGGBBBPPPBBBGGGBBBPPPPPPPPPPPPPPPPPPPPPPGGGGPPPPPPXXXXXXXXXXXXXXXXXXXXXXXXXXXXXXXXXXXXXXXXXEP
P              P           P           P                          PPPPPP    PPPPPP                                        I P
P              P           P           P                          PPPPPP    PPPPPPIIIPPPBBBPPPBBBPPPBBBPPPBBBPPPBBBBBPPPPPP P
P              P           P           P                          PPPPPP    PPPPPP                                   PPPPPP P
P              P           P           P                          PPPPPP                                             PPPPPP P
P        P     P     P     P     P     P     PVVVVVVVVVVVVVVVVVVVVPPPPPPUUUUPPPPPP                                   PPPPPP P
P        P     P     P     P     P     P     P                    PPPPPP    PPPPPPBBBBBBBBBBBBBBBBBBBBBBBBBBBBBBBB   PPPPPP P
P        P     P     P     P     P     P     P                    PPPPPP  UUPPPPPPPPBBBPPPBBBPPPBBBPPPBBBPPPBBBPPP   PPPPPP P
P        P     P     P     P     P     P     P                    PPPPPP    PPPPPP                                   PPPPPP P
P        P     P     P     P     P     P     P                    PPPPPPUU  PPPPPP                                   PPPPPP P
P        P     P     P     P     P     P     P                              PPPPPP                                   PPPPPP P
P        P     P     P     P     P     P     P                            UUPPPPPP                                   PPPPPP P
P        P     P     P     P     P     P     P                              PPPPPP                                   PPPPPP P
P        P     P     P     P     P     P     PVVVVVVVVVVVVVVVVVVVVPPPPPPUUUUPPPPPP   BBBBBBBBBBBBBBBBBBBBBBBBBBBBBBPPPPPPPP P
P        P     P     P     P     P     P     P                    PPPPPP    PPPPPP   BBBPPPBBBPPPBBBPPPBBBPPPBBBPPPBBBPPPPP P
P        P           P           P           P                    PPPPPP    PPPPPP                                          P
P        P           P           P           P                     PPPPP    PPPPPP                                          P
P        P           P           P           P                              PPPPPPPPPBBBBBBBBBBBBBBBBBBBBBBBBBBBBBBGGGGGGGG P
P        P           P           P           P                    PPPPPP    PPPPPP                                          P
PPGGGPPPPPPBBBGGGBBBPPPBBBGGGBBBPPPBBBGGGBBBPPPPPPPPPPPPPPPPPPPPPPPPPPPPGGGGPPPPPPXXXXXXXXXXXXXXXXXXXXXXXXXXXXXXXXXXXXXXXXXXP