PXXPPPPPPPPPPPPPGGGGPPPPPPPPPPPPPPPPPPPPPPPPPPPPPPPPPPPPPPPPPGGGGPPPPPPPPPPPPPPPPPPPPPPPPPPPPPPPPPPPPPPPPPPPXXXXXXXXXXPPPPPEP
P                   XXXXXX          PPPPPP      ^                PPGGPP                                                     P
P         111111                    PPPPPP      ^           PDDDDPPTTPP                                                     P
P                                   PPPPPPUUUUPPPPPPPPPPPPPPP    PPTTPP                                                     P
P                                   PPPPPP             PPPPPP    TPTTPP                                             BB      P
P         PPPPPPPPPPPPPPPPPPPPPPVVVVPPPPPP    11111    PPPPPP    TTTTTT                                         DDDD        P
P              %         PPPPPPPDDDDPPPPPP             PPPPPP    PPPPPPVVVVVVVVVVVVVVVVVVVVVVVVVVVV         BBBB            P
P  2222222     %         SPPPPPP    PPPPPPPPPPPPPPPUUUUPPPPPP    PPPPPPXXXXXXXXXXXXXXXXXXXXXXXXXXXXXXXXXXXXX                P
P              %         SPPPPPP    PPPPPP      ^      PPPPPP    PPPPPP                                                     P
P         PPPPPPPPPPPP   SPPPPPP    PPPPPP      ^      PPPPPP    PPPPPP                                                     P
PGGPPPPPPPXXXXXXXXXXXS   PPPPPPPDDDDPPPPPP      ^      PPPPPP    PPPPPP                                                     P
P        PX    $    XS   PPPPPPP    PPPPPPUUUUPPPPPPPPPPPPPPP    PPPPPP                                                     P
P        PX    $    XS   SPPPPPP    PPPPPP             PPPPPP    PSSSSSSSSSSSSSSSSSSSSSSSSSSSSSSSSSSSSSSSSSSSSSS            P
P        P               SPPPPPP    PPPPPP    11111    PPPPPS                         @  S                                  P
P        P               SPPPPPPDDDDPPPPPP             PPPPPS                         @  S                                  P
PPPPPPP  P               PPPPPPP    PPPPPPPPPPPPPPPUUUUPPPPPS       S                 @  S     S                            P
P        PPPPPPPPPPPPPPPPPPPPPPP                       PPPPPP       S                 @  S     S                            P
P        PPPPPPPPPPPPPPPPPPPPPPP                       TTTTTT       S                                                GG     P
P        PPPPPPPPPPPPPPPPPPPPPPP                       TTTTPP                                                               P
PPPPPPPGGPPPPPPPPPPPPPPPPPPPPPPPXGGXXXXXPPPPPPPPPPPPPPPPPPPPPXXXXXXXXXXXXXXXXXXXXXXXXXXXXXXXXXXXXXXXXXXXXXXXXXXXXXXXXXXXXXXXP