PXXXXXXXGGGXXXPPPXXXGGGXXXPPPXXXGGGXXXPPPXXXGGGXXXPPPPPPPPPPPPPPPPPPPPPPGGGGPPPPPPXXXXXXXXXXXXXXXXXXXXXXXXXXXXXXXXXXXXXXXXXEP
P              X           X           X         X                PPPPPP    PPPPPP                                        I P
P              X           X           X                          PPPPPP    PPPPPPIIBBBBBBBBBBBBBBBBBBBBBBBBBBBBBBBBBPPPPPP P
P              X           X           X                          PPPPPP    PPPPPP                                   PPPPPP P
P              X           X           X                          PPPPPP                                             PPPPPP P
P        X     X     X     X     X     X     XVVVVVVVVVVVVVVVVVVVVPPPPPPUUUUPPPPPP                                   PPPPPP P
P        X     X     X     X     X     X     X                    PPPPPP    PPPPPPBBBBBBBBBBBBBBBBBBBBBBBBBBBBBBBB   PPPPPP P
P        X     X     X     X     X     X     X                    PPPPPP  UUPPPPPP                                   PPPPPP P
P        X     X     X     X     X     X     X                    PPPPPP    PPPPPP                                   PPPPPP P
P        X     X     X     X     X     X     X                    PPPPPPUU  PPPPPP                                   PPPPPP P
P        X     X     X     X     X     X     X                              PPPPPP                                   PPPPPP P
P        X     X     X     X     X     X     X                            UUPPPPPP                                   PPPPPP P
P        X     X     X     X     X     X     X                              PPPPPP                                   PPPPPP P
P        X     X     X     X     X     X     X                    SPPPPPUUUUPPPPPP                                   PPPPPP P
P        X     X     X     X     X     X     X                    SPPPPP    PPPPPP   BBB BBBB BBBBB BBBBB BBBBB BBBBBPPPPPP P
P        X           X           X           X                    SPPPPPUUUUPPPPPP                                          P
P        X           X           X           X                    TPPPPP    PPPPPP                                          P
P        X           X           X           X                    TTTTTT    PPPPPPBBBBIGIIIGIIIIGIIIIIGIIIIIGIIIIIGI        P
P        X           X           X           X                    PPPPPP    PPPPPP                                          P
PPGGGPPPPPPXXXGGGXXXPPPXXXGGGXXXPPPXXXGGGXXXPPPXXXXXXXXXXXXXXXXXXXPPPPPPGGGGPPPPPPXXXXXXXXXXXXXXXXXXXXXXXXXXXXXXXXXXXXXXXXXXP