PPPPPPPPPPPPPPPPPPPPPPPPPPPPPPPPPPPPPPPPPPPPPPPPPPPPPPPPPPPPPPPPPPPPPPPPPPPPPPPPPPPPPPPPPPPPPPPPPPPPPPPPPPPPPPPPPPPPPPPPPPPPP
P                                                                            PPPPPPPPPPPPPPPPPPPPPPPPPPPPPPPPPPPPPPPPPPPPPPPP
P                                                                            PPPPPPPPPPPPPPPPPPPPPPPPPPPPPPPPPPPPPPPPPPPPPPPP
PPPP    PPPPPPPPPPPPPPPPPPPPPPPPPDDDDP                                       PPPPPPPPPPPPPPPPPPPPPPPPPPPPPPPPPPPPPPPPPPPPPPPP
PPPPP                                PPPPPPPDDDDPPPPPPPPDDDDPPPPPPPPPPPPPUUUUPPPPPPPPPPPPPPPPPPPPPPPPPPPPPPPPPPPPPPPPPPPPPPPP
PPPPPP                               P                 P    PPPPPPPPPPPPP    P                                              P
PPPPPPPPPPPPPPPPPPPPPPPPPPPPPPPP     P                 P    PPPPPPPPPP       P                                              P
P                                    P                 P                     P                                              P
P                                    P                 P                     P                                              P
P     PPPPPPPPPPPPPPPPPPPPPPPPPPP    PXXXXXXXXXXXXXXXXXPPPPPPPPPPPPPPPPPP    PPPPPPPPPPPPPPPPPPPPPPPPPPPPPPPPPPPPPPPPPPPPTTTP
P                               PBBBBPPPPPPPPPPPPPPPPPPPPPPPPPPPPPPPPPPPP    PPPPPPPPPPPPPPPPPPPPPPPPPPPPPPPPPPPP          PP
P                               PPPPPPPPPPPPPPPPPPPPPPPPPPPPPPPPPPPPPPPPP    PPPPPPPPPPPPPPPPPPPPPPPPPPPPPPPPPPP          PPP
P    PPPPPPPPPPPPPPPPPPPPPP     PPPPPPPPPPPPPPPPPPPPPPPPPPPPPPPPPPPPPPPPP    PPPPPPPPPPPPPPPPPPPPPPPPPPPPPPPPPP          PPPP
PBBBBP                          PPPPPPPPPPPPPPPPPPPPPPPPPPPPPPPPPPPPPPPPP    PPPPPPPPPPPPPPPPPPPPPPPPPPPPPPPPP          PPPPP
PPPPPP                          PPPPPPPPPPPPPPPPPPPPPPPP                 BBBBP                                         PPPPPP
P                          P    PPPPPPPPPPPPPPPPPPPPPPPPDDDDPPPPPPPPPPPPPPPPPPPPPPPPPPPPPPPPPPPPPPPPPPPPPPPPPPPPPPPPPPPPPPPPP
P   I                     PPBBBBPPPPPPPPPPPPPPP       I     I                                                               P
P   I                    PPPPPPPPPPPPPPPPPPPPPE       I     I                                                               P
P   I                  PPPPPPPPPPPPPPPPPPPPPPPPPPPPPPPIIIIIII                                                               P
PIIIIIIIIIIIIIIIXXXXXXXXXXXXXXXXXXXXXXXXXXXXXXXXXXXXXXXXXXXXXXXXXXXXXXXXXXXXXXXXXXXXXXXXXXXXXXXXXXXXXXXXXXXXXXXXXXXXXXXXXXXXX